utmynna: leda fram och öppna sig mot; resultera
lönlös: useless, futile
(en) krage: collar
skränig: blatant
brotta: wrestle
skör: fragile
vetta: face (a direction)
förebra (förebråelse): reproach; klandra, kritisera
klandra: blame, fault
bebo: inhabit, occupy
ädel: noble
(ut)mejsla: chisel (out)
intetsägande: bland
ödslig: desolate
(en) förövare: perpetrator
(ett) tillhygge: something to hit with
stötvis: intermittently
(ett) gångjärn: hinge
slipa: grind, sharpen, home
avböja: decline
barmhärtighet: mercy; (ett) förbarmande
egendomlig: strange, peculiar; konstig, märkvärdig
förebåda: foretell, herald
orubblig: adamant, unwavering
förtegen: reticent, secretive, contained; tystlåten
trotsig: defiant, obstinate
begrunda: contemplate, consider; överväga, betrakta
förbindlig: affable, courteous, obliging
snirklig: squiggly
outgrundlig: inscrutable, unfathomable; ofattbar, gåtfull
förnärma: offend; förolämpa
(en) förtret: annoyance
(en) dygd/dygdig: virtue/virtuous
håglös: listless, dull; lojt
(ett) skikt: layer; lager
spinkig: thin; mager, tunn
brysk: brusque
skygghet: shyness; blyghet
förgöra: destroy, annihilate; döda, tillintetgöra, bringa om livet
(ett) töcken: haze, mist, fog
stycka: dismember, cut up
enstöring: loner, hermit
omhänderta: take responsibility for, take care of, take charge of; ta ansvar för, ta hand om, sköta
(en) upplaga: edition; circulation
(ett) avsked: farewell
drista (sig): dare; våga
(en) vrede: wrath; ilska
skenhelig: hypocritical; hycklande
obeveklig: relentless
förbehållslöst: unconditionally, without reservations
förbehålla: reserve, demand
begråta: mourn
vanära: disgrace, dishonour; skam
fullända: prefect, bring to perfection; fullborda
fullkomlig: perfect
(ett) rabalder: uproar; oväsen, bråk, uppståndelse
uppståndelse: commotion, stir
förståndig: sensible
framvällande: emergent
gnissla: squeak
anhålla: arrest, apprehend/formally request
förädla: refine
kluven: split, forked
gira: yaw, swerve, veer
förkunna: proclaim, declare
(en) reträtt: retreat; återtåg
återtåg:
(en) rekyl: recoil
begynnelse: initial
gynna: favour, promote
annalkande: approaching
utskällning: scolding, telling of
runka: jerk off
lemlästa: main, mutilate
fördärvlig: pernicious
subventionera: subsidise
åsamka: cause, incur
oöverstiglig: insurmountable
vanvördig: irreverent, disrespectful
snuskig: filthy, nasty; obscene
försumma: neglect
bårhus: morgue
medbrottsling: accomplice
trångboddhet: overcrowding
trång: narrow, tight, crowded; snäv
förfogande: disposal
majestätisk: majestic
överösa: overwhelm; överväldiga
(ett) vittnesbörd: testimony
(ett) välstånd: prosperity, affluence, well-being
(en) vigselakt: wedding ceremony
förnimma: perceive (with the senses); uppfatta
salig: blessed; välsignad
mållös: tongue-tied, speechless
beryktad: infamous
rykta: groom
bräcklighet: fragility
sluddra: babble
(ett) kval: pangs, anguish, torment; lidande
(ett) signalement: characteristics, description
rentvå: cleanse, clear, purge
avvisande: dismissive
fundersam: pensive, thoughtful; efter­tänksam
stänka: splash
återgälda: reciprocate
förvissa: assure
förära: make a present
dyrka: worship, adore, idolise
livmoder: uterus
avbild: image, likeness
briljera: shine, show-off; glänsa, pråla
lågmält: low-key, discreet
förakta: despise, disdain, scorn, contempt
infallsvinkel: angle of incidence, angle of attack/aspect
sakkunnigutlåtande: expert opinion
slående: striking
glåmig: wan, pasty
(ett) svalg: throat, chasm, abyss
blotta: bare, expose, uncover; göra synlig
blottare: exhibitionist, flasher
(en) skyffel: shovel
nedbruten: uppriven; mentally broken
(en) flytväst: lifejacket, safety vest
frånvarande: absent, distant
hycklare: hypocrite
tukta: chastise, punish
asätare: scavenger
intäkter: return, yield, proceeds, income, revenue; avkastning, inkomst
vansköta: neglect, mismanage
gläfsa: yelp
avsäga sig: renounce
vidunderlig: wonderful
långlint: resentful
fåfäng: vain/futile; kokett/fruktlös
småaktig: captious, quibbling
ovårdad: unkempt
(en) samverkan: cooperation
förbrytelse: crime, offence
tänja: extend, stretch
förorätta: wrong, offend, hurt; såra, förolämpa
gro: germinate, sprout
lyhörd: responsive, keen
vanställa: disfigure
förräderi: treason
(ett) svek: betrayal, treachery, deceit; bedrägeri, förräderi, trolöshet
bedrägeri: fraud, deception
kulspruta: machine gun
spruta: syringe
stämband: vocal cord
härma: mimic, imitate
avdunsta: vaporise, evaporate; förånga
förånga: vaporise
hjärtskärande: heartbreaking
lagföra: prosecute
utsöndra: secrete, exude
bukhåla: abdominal cavity
vävnad: tissue, fabric
sköldkörtel: thyroid gland
binjure: adrenal gland
njure: kidney
lie: scythe
övermod: arrogance
vanmäktig: powerless; kraftlös
omsluta: enclose, embrace
bedra: deceive; lura, svika
ombonad: snug, cozy; välordnad, trivsam
rännsten: gutter
torftig: meagre, simple
oräknelig: innumerable, countless
otalig: countless, uncountable, innumerable; oräknelig, tallös
gudomlig: divine
nyckfull: whimsical, capricious; erratic
sträv: rough, coarse/hard, harsh; grov, ojämn/kärv
hågkomst: recollection
undergiven: submissive, passive
ofantlig: immense; kolossal, väldig
förvränga: distort, scramble
(en) åtrå: desire, lust (after), yearn
attrahera: attract, draw
varaktig: lasting, durable
medtagen: exhausted; utmattad
genskjuta: overtake, intercept
förenlig: compatible
flott: classy/afloat/melted fat
behändig: handy, useful
dyna: cushion
genklang: reverberation, echo/reply, response/sympathy
ynklig: pitiful; ömklig
omtumlad: dizzy; yr
avföring: faeces, defecation
(en) lymmel: rascal, scoundrel
likgiltig: indifferent
dov: dull, muffled
(en) imma: vapour, condensation
projicera: project
övergå: go over, exceed
(en) slöja: veil
omställning: conversion, adjustment
foglig: docile, tractable
olycksalig: unfortunate
hopflätad: intertwined
pyra: smoulder
mödosam: arduous; tröttsam
(ett) stygn: stitch
skonsam: gentle
(en) störtskur: torrential rain
nederbörd: rainfall; regn
fastslå: state, establish; ställa upp
ställa upp: state, establish/participate/stand up (for)
erhålla: obtain; få ut, skaffa
hyfsad: decent; ganska bra
begripa: comprehend, grasp; förstå
tänkbar: conceivable
hejdlös: rampant, wild; obegränsad
flink: nimble, quick
rådande: current, prevailing, ruling; nuvarande, pågående, föreliggande, löpande
föreliggande: present
godtycklig: arbitrary, random
omvänt: conversely, vice versa; å andra sidan
utlösa: trigger
förslå: suffice; räcka till, vara till­räcklig
speja: spy; spana
spana: scout, spy
frånstötande: repulsive, repugnant
stötande: offensive
rymma: hold, contain, accommodate; innehålla
medurs: clockwise
moturs: anti-clockwise; motsols
återuppta: resume
för den delen: for that matter
antyda: imply, suggest
mojna: abate; stillna, avta
avta: abate, subside
omvälva: revolutionise, overturn, transform
omvälvning: upheaval
försätta: put, set
beveka: appeal to and persuade; övertala
mottaglig: susceptible
tillförlitlig: reliable, trustworthy; pålitlig, trovärdig
redogöra: explain, describe; beskriva, berätta om
förlossning: childbirth
ovärdelig: priceless, invaluable
(en) brits: bunk
spänna: tighten, tense up; strama till
illa tilltyga: hurt, injure, abuse; skada, misshandla
sarga: lacerate, tear apart; såra, slita sönder
sörja: grieve, mourn, wet mass
understöd: subsidy, allowance, aid
indrivare: debt collector
(ett) stängsel: fence, enclosure
stegra: rise, raise, enhance, intensify; öka, höja
(ett) brosk: cartilage
åtkomlig: approachable, accessible, reachable
bildlig: figurative
uthärda: endure, bear, tolerate; stå ut med
(en) håg: mind/inclination, propensity; sinne/böjelse, lust
tvetydig: ambiguous
plump: indecent, rude, rough; ohyfsad, grov
(en) genans: embarrassment; att vara generad, förlägenhet
skyla: cover, veil; gömma, dölja, hölja
hölja: cloak, shroud, cover; övertäcka, skyla, dölja
obduktion: autopsy
påkostad: extravagant
(ett) anletsdrag: facial features
stympa: mutilate, maim/truncate; lemlästa, van­ställa genom av­skärning/förkorta
(en) vad: calf
trängs: to crowd
(en) härsklystnad: domination, thirst for power
utrota: eradicate; utplåna, förinta
fördunkla: cloud, obscure, obfuscate
avgrund: abyss, chasm
måttlig: moderate, mild
(en) fadäs: gaff, blunder; (en) tabbe
framkomma: emerge
skåda: behold, see; se, betrakta
åskådliggöra: illustrate, visualise
åskådare: spectator, audience
gles: sparse, thin, scattered
fresta: tempt; locka
(ett) tillvägagångssätt: approach
infinna sig: show up, turn up, appear (to a meeting)
hållning: posture, demeanor
befängd: absurd, ridiculous; tokig, löjlig
löjlig: ridiculous, ludicrous; löje­väckande
gola(re): snitch
treva: fumble, grabble; famla
tinning: temple
förlägga: place, misplace/publish
olovlig: unlawful, illegal; olaglig
avlyssning: eavesdropping
förmaning: admonition, warning
övermanna: overpower
(en) bekännelse: confession
ömka(n): pity
(ett) uppsåt: intent; avsikt
förutsägbarhet: predictability
ljum: luke warm
(en) askkopp: ashtray
oåterkallelig: irrevocable
luder: whore
slinka: slip, slide; kila, smita
kila: scurry, scamper
smita: sneak away/crowd
smita åt: fit tight
sprudlande: exuberant
skymta: (catch a) glimpse
skönja: discern; urskilja
avse: intend, concern, refer to; syfta på
(en) dust: bout, tussle; strid, kamp
(ett) förlopp: sequence, course of events; skeende
i och med: as a result of, since, because; eftersom, därmed
därmed: thereby, consequently, with that
så pass: so, such
besinningslös: reckless; obehärskad, rasande
skräna: yell, shout; skrika, väsnas
tillmötesgå: accommodate, oblige; bifalla, bevilja
läppja: sip; smutta
smutta på: sip
entonig: monotonous
återställa: restore, reset
återupprätta: restore, reestablish
upprätta: establish, set up; skapa
undertrycka: suppress, subdue; dölja, underkuva
underkuva: subjugate
skir: transparent, clear/brittle, fragile; genom­skinlig; spröd, öm­tålig
skäll: scolding, telling-off
befogad: justified; berättigad, skälig
skälig: reasonable; rimlig
rimlig: reasonable
lustbetonad: lustful, pleasurable
(en) buk: abdomen
omvårdnad: nursing care
övermod: arrogance
(en) rotel: division; avdelning
snava: stumble, trip; snubbla
fryntlig: jovial; godmodig, vänlig
ila: hasten, hurry; skynda
vingla: wobble, sway
upprymd: merry, excited; glad, munter
munter: cheerful, merry
sagoaktig: fairytalelike
grumlig: cloudy, murky
(en) heder: honour
uppriktig: sincere, frank; ärlig, rak
tramsig: silly, not serious; fånig, larvig
larvig: silly; fånig, fjantig
uppfordra: encourange; uppmuntra
fordra: require, demand
svälta: starve
rämna: break apart, crack; brista itu, spricka
förfalla: decay, deteriorate/lapse, expire; försämras/upphöra
samlag: sex(ual intercourse), coitus
uppskov: suspension, delay, postponement; anstånd
prestanda: performance; föreställning
(en) kofot: crowbar
(en) tönt: dork
vad går det ut på: what is it all about
stimma: be noisy, make a noise
bortanför: beyond; bortom
(en) återstod: residue, remains
rapa: burp
besättning: crew/herd
omfattning: extent, scope; utsträckning
(en) ljumske: groin
(en) spärr: latch, lock, bar
komma över: come across
av en slump: by accident
snubbla på: stumble upon
avvika: deviate, diverge
förlegad: outdated, obsolete, antiquated; föråldrad
hisna: turn giddy/dizzy; svindla, bli vimmelkantig
vimmelkantig: giddy, dizzy
(en) beska (beskhet): bitterness
(ett) anslag: allocation, grant, allowance/announcement, notice/intrigue, conspiracy
sammansvärjning: conspiracy
försmädlig: annoying; sneering, provocative; retsam, irriterande
frusta: snort; fnysa
fnysa: snort
anspänning: tension; ansträngning
spanning: voltage/tension/excitement
utan omsvep: direct, without evasions; rättfram, utan undanflykter
undanflykt: evasion
flummig: high (on drugs), intellectually messy
pampig: grand, pompous; ståtlig
ståtlig: stately, handsome
skev: skewed; sned
genomgång: review, going through
nämnare: denominator
(ett) övergrepp: abuse
frammana: conjure up, call forth, evoke
kisa: squint
pösa: bloat, swell; svälla
förställa: disguise, pretend
efterhängsen: persistent; ihållande
självförvållad: self-inflicted
vålla: cause, inflict; förorsaka
lystnad: eagerness, desire; begär, åtrå
brås på någon: rush at someone
blossa: flare, flush
dalta: coddle
stöka: tidy up, clean
stöka till: make a mess
skälmaktig: mischievous
okynnig: mischievous, impish
försåtlig: malicious, insidious; lömsk, som döljer sin farlighet
lömsk: insidious, sinister
utåtriktad: outgoing, extrovert
stygg: naughty, wicked
förföra: seduce
fåfäng: vain/fruitless
finurlig: tricky, clever; knepig, fiffig
fiffig: clever, ingenious, smart; påhittig, klipsk
ragla: stagger: vackla, vingla
avfärda: dismiss
vämjelse: loathing; äckel, avsky
avsky: loathe, detest
skrot: scrap
skrotupplag: scrap yard
disträ: distraught, absent-minded; tankspridd
stup: precipice, cliff; avgrund
utbytbar: interchangeable
utöka: expand, enlarge, augment
utvidga: widen, broaden, expand
rasera: demolish, tear down, destroy; förstöra, riva ned
beklämd: depressed; deprimerad, nedstämd
oklanderlig: impeccable, immaculate; felfri
förödmjuka: humiliate, debase; förnedra
omtöcknad: dazed, stupefied
illavarslande: ominous
varsla: bode, fortell; före­båda; för­varna
näpen: pretty, cute; söt, nätt
(en) gylf: zipper, fly
nedstänkt: drenched
berömma: praise, commend; prisa
utvändig: external
förmana: caution, warn
uppmana: invite, request
anstalt: institution
i drift: in operation
(ett) galler: grid, grill, grating, lattice
förse: provide, supply, equip; utrusta
undslippa: elude, escape; undkomma
lägga näsan i blöt: meddle in; blanda sig i
ödesdiger: fatal, fateful; olycks­bringande
ödesmättad: fateful
sinnesnärvaro: presence of mind
omständlig: detailed, long-winded, verbose, tedious; utförlig, mångordig
invecklad: intricate, convoluted, complicated; komplicerad
obönhörlig: inexorable, inevitable/relentless; ofrånkomlig/obeveklig
ofrånkomlig: inevitable; oundviklig
vresig: grumpy, cranky; grinig
grinig: grumpy, petulant
förefalla: appear, seem, look; tyckas, verka
fastna för: get hooked
hägring: mirage, illusion; synvilla
skildra: depict, describe; beskriva
motsägelsefull: contradictory
vekna: weaken, soften; mjukna
somliga: some, certain; vissa, några
tämligen: rather, fairly, pretty, quite; ganska, någorlunda
någorlunda: fairly, somewhat
putslustig: funny, jokey; smårolig, skojig
lustig: funny, amusing; rolig
(en) bagatell: trifle, triviality, small matter; små­sak, strunt­sak, o­betydlighet
bagatellartad: trivial, petty
ens vana trogen: true to one's habit
(ett) glåpord: profanity
(ett) skjul: shed
listig: cunning, clever; slug, smart
smeka: caress, fondle
(en) tingest: thing, object; föremål, sak
motvilja: aversion
ingjuta: instill; inge
kuslig: terrible/eerie, creepy; hemsk, ruskig; ängslig
erfordelig: needed, necessary; behövlig, nödvändig
nogräknad: demanding; fordrande, krävande
oförglömlig: unforgettable
reslig: tall, towering; hög­rest, hög­växt
förströ: entertain, amuse/distract, divert; roa, underhålla/distrahera
infoga: insert, put in; sätta in
sannerligen: indeed, certainly; förvisso, verkligen
förvisso: certainly
förfärlig: awful, terrible
beskedlig: modest, humble, shy, good-natured; försynt, snäll, blygsam
försynt: shy, modest; blygsam
sävlig: slow; långsam, maklig
maklig: leisurely, unhurried; långsam, sävlig
tiga: shut up, be quiet
vett: wit, sense; förstånd, omdöme
bedöma: assess, judge
inackordering: board and lodging
ströva: stroll, ramble
makalös: incomparable, unmatched; o­förliknelig
hårdhänt: rough, heavy-handed
uppseende: surprised attention
överordnade: superior (position)
föredömlig: exemplary; förebildlig
framgå: become clear, evident; följa logiskt
fördom: prejudice, bias
utomordentlig: extraordinary, outstanding
misshag: dspleasure; missnöje
förtrytelse: resentment, indignation
gliring: sneer, taunt, jibe
(ett) överseende: indulgence; tolerans, fördragsamhet
fördragsamhet: tolerance, leniency, forbearance
höra sig för: inquire; fråga om/efter
vedertagen: established, generally known
ta udden av: deaden, dampen; döva
(en) udde: cape, point
unna: treat, grant
bedarra: abate, calm down; mojna, avta
enfaldig: silly, foolish
(ett) fördärv: destruction, corruption, depravity
högmod: proud arrogance
vittna: testify
näringsliv: business life, trade and industry
vederhäftig: objective, factual, compelling/reliable; saklig/pålitlig
fjärran: far away; avlägsen
prål: boasting, bragging, ostentation; ståtande
ståta: parade, flaunt
svassa: strut about, prance; kråma sig, ståta
kråma sig: prance about, strut 
fallenhet: aptitude, talent/proneness; anlag/benägenhet
hisnande: breathtaking; fantastisk
i or och skur: rain or shine
rata: reject, refuse, scorn; inte finna god nog, försmå
inlevelse: empathy
bistå: assist
vandel: behaviour, conduct, way of life; upp­förande, levnads­sätt
bävan: trepidation, dread; stark oro
förträfflig: excellent, splendid
anständig: decent, proper, respectable; hygglig
ohygglig: horrible, monstrous; fruktansvärd
ständig: permanent
hygglig: pleasant, nice; vänlig, trevlig
skämma bort: spoil
huller om buller: helter skelter, quickly and in all directions
förena: join, reconcile, unify
yvig: bushy, fuzzy
renhårig: respectable, reliable, decent; hygglig, pålitlig
omvittna: vouch for, guarantee
efter förtjänst: according to merit 
varsko: (fore)warn, notify; förvarna/underrätta
lövverk: foliage
föga: little, hardly, not exactly
inskränka: restrict, limit; begränsa
kränka: violate, infringe; bryta mot
räckvidd: scope, range, reach; omfattning
överskrida: exceed, overstep; överstiga
insyltad: involved; inblandad
kväljning: gagging
förinta: annihilate, consume, destroy; utrota, utplåna
(en) vålnad: ghost, phantom; spoke
begagna: use, make use of; använda
belevad: well-bred, polite; hövlig, artig
hövlig: polite, civil, courteous; artig
ansenlig: considerable, substantial; betydlig
efterbliven: retarded
vitsig: witty
klipsk: clever, shrewd, resourceful
i och för sig: in and of itself
uppvigla: incite
förhåna: mock
häda: blaspheme
tveeggat: double-edged
öknamn: nickname
ymnig: abundant, ample, plentiful; riklig
uthållighet: persistence, endurance
uppsluppen: in high spirits, exhilarated, jolly; munter
tankspriddhet: absentmindedness
nådig: gracious, merciful
bifall: applause/consent, approval, endorsement; samtycke
mörbulta: bruise
således: thus, therefore; därför
begeistrad: enthusiastic, excited; hänförd, förtjust
förtjust: delighted 
hänförd: enthusiastic; förtjust
beståndsdel: ingredient
ur­skilja: distinguish, discern, perceive; förnimma, uppfatta
tidsödande: time-consuming
lidelse: passion, yearning; åtrå
luttrad: hardened, seasoned
hemtam: well acclimated
belåten: satisfied, pleased; nöjd, glad, tillfredsställd
(en) säd: seed, grain
händelsevis: accidentally, by chance; tillfälligtvis
behörig: appropriate/competent/authorised
hålla sig på mattan: behave appropriately, stay in line
kärv: harsh, stringent; sträv
ruva: brood
på picka­lurven: drunk; berusad
så när som på: apart from, except for, save
utöver: apart from, besides
nödbedd: difficult to convince
bemöda sig: endeavour, make an effort, exert oneself; anstränga sig
inte så pjåkig: not bad, quite good
avlösa: relieve, replace; ersätta, efter­träda
ideligen: continually; oavbrutet
krokig: crooked
vettvilling: madman
okynnig: mischievous
snylta på: sponge off, parasitise; leva på andra
förströdd: preoccupied, scattered; tankspridd
välbehållen: safe, whole; som klarat sig utan skador
förskingra: embezzle, misappropriate
skingra: dispel, disperse, dissolve, disband
besinna: consider, think of, reflect
besinna sig: come to one's senses; sansa sig
företa: undertake (a trip)
(ett) tilltag: prank, trick/venture
lägga om: rearrange
snäcka: shell
framföra: express, convey/perform, present; säga, yttra/spela
rask: brisk, swift, quick; snabb, flink; pigg
bedriva: pursue, conduct; utöva
utpressning: extortion
(en) stiltje: lull, calm; vindstilla, bleke
gehör: musical ear
framträda: appear, emerge; uppträda
uppträda: appear/behave; framträda/bete sig
skiljedom: arbitration
anmärka på: criticise, fault; klandra, kritisera
anmärkningsvärd: remarkable, noteworthy
pil: arrow
pilspets: arrowhead
sjuda: simmer
ökänd: notorious, infamous; beryktad, illa känd
likvärdig: equivalent
sväva: float, hover
utebli: fail to appear
anhörig: close relative
tvärsäker: absolutely sure, positive
avsätta: set aside
(ett) sammanträde: formal meeting; mote
än så länge: so far
butter: grumpy, morose
uppvisning: display, show, parade
utförsel: export
avsats: ledge
(en) tillstymmelse: sign, indication, flicker, shred
på smällen: pregnant
ta reda på: check, make sure
ringa in: define carefully
gängse: prevalent
tilltäptning: occlusion, obstruction
strypa: strangle
fåra: furrow, groove
ögla: loop
klämma: clamp, squeeze, pinch
spjuver: person who jokes
ovedersäglig: irrefutable, indisputable
bestrida: contest, challenge, deny
krusning: ripple
mätta: fill, satiate, saturate
befalla: command, order
utrymma: vacate, evacuate, empty
belägg: evidence; bevis
förta: deaden, dampen
gro: germinate, sprout, grow
inrymma: accommodate; hysa
hysa: house, harbour
återhämtning: recovery
otymplig: awkward, clumsy; oformlig, klumpig
klumpig: clumsy
skallgång: search party
visserligen: certainly, admittedly; förvisso
tillvarata: take care of, take charge of
utlåtande: opinion, verdict
föreligga: exist; existera, finnas
tilltagande: increasing, rising
tillta: rise, increase
antasta: accost, molest
framskrida: progress, advance
allteftersom: as, gradually
upplopp: riot
kravaller: street riots
pådrag: crackdown, mobilisation, operation
tillslag: raid
(en) bråte: lumber/clutter
beslag: seizure, confiscation
(en) sena: tendon
gemytlig: genial, jolly, good-humoured; godmodig, fryntlig
uppjagad: worried, strained, anxious; orolig, ängslig
klister: adhesive, glue
(en) haj: shark
överlägsen: superior
efterträda: succeed, follow, replace
bevarelse: preservation
varelse: being, creature
tygla: curb, rein in, restrain
sedeslös: immoral
sedelärande: moral, edifying
klandervärd: reprehensible
intala: talk into, persuade; övertyga, övertala
omstridd: disputed, contested, debateable
beviserligen: obviously, demonstrably
rekvirera: requisition
upprätthålla: maintain, keep up
kysk: chaste
skenbar: apparent, seeming
hängiven: dedicated, devoted
(ett) bud: bid, offer
påstridig: assertive
omaka: odd, ill-matched, incongruous
sävlig: sloppy, slow
förmånstagare: beneficiary
anspråkslös: unassuming, modest; blygsam
foga: add, join
foga samman: 
gå grundligt tillväga: proceed thoroughly
avråda: dissuade
överlämna: submit, hand over/surrender
vurm: craze
loj: indolent, sluggish; trög, håglös
trög: sluggish, slow, dull
tröghet: inertia
uppspelt: exhilarated; munter
satsa på: bet on, risk
tillskriva: attribute, acknowledge; tillerkänna
(en) sägen: legend, tale
förfarande: procedure
anlita: hire
(en) bulvan: decoy, dummy
företräda: represent, precede
idka: practice, conduct; bedriva, utöva
äkthet: authenticity, genuineness, originality
förargelse: annoyance, vexation
överlåta: transfer, assign, depute
utan omsvep: straight out, without evasions; utan undanflykter
möda: toil, effort; ansträngning
formligen: positively, literally; i sanning, verkligen
förhala: delay; fördröja
vina: whiz, hiss, swish; susa
(ett) läger: camp, compound
likhet: resemblance, similarity
förfärad: horrified
(en) förfäran: horror, dismay
avvara: spare
bli varse ngt: notice, become aware of
(en) trave: pile, stack; stapel
(en) stapel: stack
bukta ut: belly out, bulge out
få bukt med: get under control, manage
utfall: lunge, fierce attack/result, outcome; häftigt an­grepp/resultat
infall: sudden idea
villospår: red herring
(en) frist: postponement, reprieve; upp­skov, an­stånd
aptera: adapt, fit; anpassa
tiga: shut up, keep quiet
avskum: scum
skum: foam/obscure, dim/doubtful, suspicious; dunkel/tvivelaktig, miss­tänkt
(en) oroshärd: trouble spot, hotspot for trouble
bägge: both; båda
(ett) reglage: controls; reglerings­anordning
sirlig: graceful, elegant
snida: carve
bestycka: arm, equip
ytterlighet: extreme
gagna: benefit
taggtråd: barbed wire
förvilla: bewilder
maskros: dandelion
bedyra: assert, protest
oförmögen: unable, incapable
omsätta: convert, transform/sell; överföra, omvandla/sälja
omsättning: turnover
förbise: overlook, miss, disregard, ignore
(ett) klavertramp: severe social blunder
missvisande: misleading, deceptive
besitta: possess, own, have
överge: abandon, forsake
spröd: brittle
(ett) yttre: exterior, look; utseende
mån: eager/considerate/degree, extent; angelägen/omtänksam/grad, utsträckning
omtänksam: thoughtful, considerate
inälvor: entrails, guts; tarmar
ertappa: catch someone in the act/red-handed
kana: slide, glide
vädra: vent(ilate), air out/sniff/sniff out, detect, sense; lufta/sniffa/ana
(ett) krön: crest, peak, top
(ett) uppslagsverk: encyclopaedia
töntig: silly, stupid; fjantig, dum
(en) strupe: throat
inkräkta: intrude, encroach, trespass
segna: sink down to the floor
rossla: wheeze
frodig: lush
efterfrågan: demand
tillgodose: accommodate, fulfill; uppfylla
stjälpa: overturn, topple; välta
(en) mened: perjury
omfattande: extensive, comprehensive
genomsyra: permeate
tillintetgöra: annihilate, exterminate, extinguished; förstöra, krossa
inställsam: attentive, ingratiating; insmickrande
insmickrande: ingratiating
ledsaga: escort
hack: hedge
vinda: squint
förseelse: offence, misdemeanor
lindrig: mild, minor, light
innebörd: meaning, implication, significance
ohyra: vermin
enträgen: insistent, persistent; ihärdig, outtröttlig
truga på: urge someone to accept something
släntra: saunter, loiter, amble
slänt: slope, incline
slät: smooth, even, flat
avigt inställd: negatively disposed, unfavourably inclined
skärrad: shaken, unnerved; upphetsad, uppjagad; orolig, nervös
lotsa: pilot, guide, navigate
bister: grim, harsh, stern
barsk: stern, harsh; bister
skyndsam: hasty, hurried
ösa: scoop, pour, ladle
gäll: shrill, high-pitched
ihålig: hollow
sjaskig: shabby, dirty, tattered
innan man vet ordet av: before you know it
vara illa ute: be in trouble
tillfoga: add/inflict, cause; tillägga/vålla
avsevärd: considerable; ansenlig, betydande
sevärdhet: tourist attraction, sight 
åtskillig: several, many, quite a lot; en hel del, olika, flertal
förglömlig: forgettable
misslynt: cranky, bad-tempered, irritable; missnöjd, sur
luddig: fuzzy, fluffy
taggig: prickly, thorny, harsh; kärv, o­vänlig
(ett) smil: smile, smirk, grin; leende
rör på påkarna: get moving; sätt fart
bedrift: feat, achievement, accomplishment
endräkt: unity, unanimity, harmony; enighet, sämja
betäcking: cover, shelter
utföra: perform, execute
överträffa: surpass, exceed, outdo; bräcka
bräcka: outdo/crack, breach, break; överträffa/bryta, knäcka, krossa
hurtig: brisk, perky, energetic, spirited; käck, rask
vörda: revere
beträffa: concern, regard
förplikta: oblige, obligate, bind
medryckande: captivating; fängslande, spännande
fängslande: captivating, enthralling; spännande
hängig: limp
(en) lort: dirt, filth, muck; smuts
dynga: droppings, dung; rubbish
utmärglad: emaciated, lank, wasted; mager, av­tärd
mager: lean, skinny; tanig
knapra: nibble
möglig: moldy
arvtagare: heir, inheritor
överfall: assult; plötslig attack
anfall: angrepp; attack
angripa: attack; an­falla, attackera
vanka av och an: wander back and forth
intet ont anande: unsuspecting; aningslös
inverka: influence, have an effect; styra, förändra
oförtruten: relentless, unrelenting; outtröttlig, ihärdig
ihärdig: persistent; beständig
meningsskiljaktighet: dissent, disagreement
skiljaktig: different, divergent; olik, avvikande
försegla: seal
repa: scratch, scrape; rispa, skåra
rispa: scratch, cut
skåra: cut, groove, incision
skråma: scratch, cut
skava: chafe, scrape; skrapa, gnida
gnida: rub, scrape
skryta: boast, brag
modfälld: demoralised, discouraged, disheartened; dyster, nedslagen
nedslag: impact, crash
förvärva: acquire, obtain
vildsint: wild, savage
knepig: tricky
(ett) krångel: hassle, trouble
stundande: forthcoming, imminent; förestående
förestående: impending, approaching; kommande
förestå: be head of, be in charge of
underkasta: submit, subject; surrender to
utmanare: challenger
bedrövlig: deplorable
förtöja: moor
(ett) bryderi: perplexity; förvirring, förlägenhet
villådig: indecisive, irresolute; obeslutsam, teksam
skärpa: sharpness
försona: reconcile; göra sams
svida: sting
besinna: think over carefully, reconsider; tänka om sig för
ödmjuk: humble
riddare: knight
obefintlig: nonexistent
entydig: unambiguous
(ett) omslag: cover, wrapper
axelryckning: shrug
utgift: expense; kostnad
(ett) förbarmande: mercy, pity
(en) fälla: trap
(en) slev: ladle
ättling: descendent; avkomling
högtidlig: solemn, grave, scared
florslända: dragonfly
(en) örsnibb: earlobe 
tillgiven: affectionate, loving; öm
gruva sig: worry, be anxious; oroa sig, ängslas
spydig: snide, sarcastic; hånfull
tunna: barrel
förtrogen: familiar
hemmastadd: at home, comfortable
gräslig: awful, ugly, unsightly; hemsk
skräddarsy: tailor; anpassa precis
måttet är rågat: enough is enough
väta: wet, moisture; fukt
evinnerlig: eternal, everlasting; evig
usel: wretched, miserable, pitiful
uteslutande: exlusive(ly)
anseende: reputation; rykte
(ett) rykte: rumour, reputation
bistånd: assistance, aid
motgång: adversity
motsträvig: ovillig
lynning: moody
fly sin kos: disappear, escape
förkärlek: penchant, fondness, predilection, partiality
vidunder: monster
sky några medel: do whatever is necessary to achieve something
sky: avoid, shun; undvika
forntid: ancient times
bestört: dismayed, aghast; häpen, förskräckt
som väl är: fortunately, thank goodness
spatsera: stroll, saunter, amble
utnämna: appoint, nominate; utse
återstå: remain, be left
återvändsgränd: blind alley, dead end, impasse
tyglar: reins
lealös: limp; slapp
stum: mute, dumb, silent, speechless
lättja: laziness
snurra: spin, twirl, turn
genomskåda: see through, find out; avslöja
sällsam: peculiar, odd, strange; besynnerlig, egendomlig
besynnerlig: peculiar, odd; konstig, märk­värdig
slå slint: backfire, misfire; misslyckas
bära sig åt: behave; bete sig, uppträda, uppföra sig
uppföra sig: behave, conduct oneself; bete sig på visst sätt
förtälja: tell; berätta
haja till: shake, become startled; rycka till
rycka: twitch
tvättäkta: genuine, authentic
smrta: smear
storslagen: magnificent, grand; ståtlig, storartad
i gengäld: in return
bakfull: hungover
bördig: fertile, fruitful; fruktbar, givande, högavkastande
högavkastande: high-yielding
karg: barren
avskräcka: discourage
införliva: incorporate, annex; överta
vittra: wither, decompose
iscensätta: stage
övergripande: overall, overarching
gärning: deed, action
brisera: burst, explode
uppstå: arise, emerge; bli till
återuppstå: resurrect, reemerge
resterande: remaining, residual
muta: bribe
motprestation: quid pro quo, service in return, counter performance
upplägg: layout, arrangement
fördöma: condemn
sedermera: subsequently
(en) hänsyn: consideration
(en) räd: raid
mestadels: mostly
förlita sig (på): rely on
urskillningslös: indiscriminate
godtycklig: arbitrary, random
sårbar för: vulnerable to
tillskansa sig: usurp, obtain by force
få till: achieve, accomplish; lyckas åstadkomma
åstadkomma: achieve, bring about, cause: uppnå, förverkliga
te sig: seem, appear; visa sig, förefalla
utlysa: announce; tillkännage
tillkännage: announce
ledigförklara: declare as vacant
uppresa: rise, revolt/raise, erect
fernissa: varnish/veneer
belägring: siege
rungande: resounding
rättsväsende: judiciary
överblick: overview
bitvis: here and there, bit by bit
stifta: found, establish; grunda, skapa, inrätta
inrätta: set up, create
omgång: round, set
alltjämt: still; fortfarande
jämt: always, every time, constantly; alltid, ständigt
i det avseendet: in the sense that
beständig: resistant, steady; bestående, varaktig
bestående: permanent, lasting
företeelse: phenomenon
motvillig: reluctant
beakta: observe, pay attention to; ta hän­syn till, upp­märksamma
ta för givet: take for granted
få fäste: gain a foothold
klåpare: blunderer
tillhandahålla: provide
underbygga: substantiate
dåraktig: foolish
förskoning: pardon, mercy
jäkta: rush, hurry on
(ett) uppror: rebellion, uprising 
lönnmörda: assassinate
(en) lönn: maple
värna: protect, defend; försvara, skydda
värna om: cherish; omhulda
härstamma: originate
fortlöpa: go on, proceed, continue
febril: excited, bustling; upphetsad, jäktande
invända: object
hänföra (till): assign, relate/fascinate, entrance; räkna till/fascinera
rusa: rush, rev up
störta: rush, dash, dart, hurtle, overthrow, topple
(en) sekel: century; århundrade
urholka: hollow out, dig out, excavate; urgröpa
rättfärdiga: justify, excuse, vindicate
rättfärdig: righteous, just
lucker: loose; lös, porös, gles
fördrag: treaty, pact/forbearance; avtal, pakt/tålamod
till råga på allt: to top it all off
stadga: charter, statute
sammanhållning: cohesion, unity
motsättning: antagonism, opposition, disagreement
vedergällning: retribution, retaliation
lägga om: rearrange, reshuffle
åtgång: demand and sales, consumption; förbrukning
(en) legoknekt: mercenary
förjaktligen: consequently; alltså, således
alltså: in other words
förgäves: in vain
beslagta: seize, confiscate
(en) föresats: intention, goal, purpose; avsikt, mål
eftertryck: emphasis; betoning, skärpa
förment: supposed(ly); förmodad, inbillad
(ett) inflytande: influence
fastslå: settle, establish, fix
omdana: reshape, remodel, remodel, transform; omskapa
väsentligen: essentially, intrinsically; huvudsakligen
skrota: scrap, junk, dismantle
förhållningssätt: attitude, outlook, approach; attityd, synsätt
rättfram: straightforward, direct
syna: inspect; besiktiga
syna en bluff: call a bluff
jaktflyg: fighter jet
förevändning: pretext, excuse
anföra: express, state, cite
inför öppen ridå: openly, before everyone's eyes; i allas å­syn
bli av: occur, happen; inträffa, hamna
övertag: lead, advantage; försprång
försprång: lead, advantage; övertag
utsago: statement; uttalande, påstående
uttalande: statement
omättlig: insatiable
upprinnelse: origin, source; ursprung, härkomst, upphov, källa, orsak
upphov: origin, cause, source, root
(en) tvist: dispute
(en) bundsförvant: ally
onämnbar: unspeakable
uppdata: discover, reveal; upptäcka, avslöja
begärlig: in demand, sought after
värva: solicit, recruit, enlist, enroll
slå ut: bloom/outdo; blomma/bräcka, besegra och eliminera
nöta: wear out; slita
nött: worn, shabby; sliten
utnötning: exhaustion, wearing out; förslitning
slitning: abrasion, friction
(ett) slit: toil
Förintelsen: the Holocaust
synnerligen: particularly; särskilt, ytterst
ödelägga: devastate; härja, skövla
inleda: initiate, start with
förorda: advocate, counsel, recommend; förespråka
(ett) anspråk: claim, pretence, interest
återhållande: restraint
förverka: forfeit; förlora, gå miste om
utge sig: claim to be, pretend
ange sig: report, announce; anmälla
ange: state, indicate, inform
motsätta sig: oppose, counter
kväsa: quell, subdue, stifle, crush; kuva
snudd på: almost, nearly; nästan, nära
spänstig: resilient, vigorous; smidig och stark
lägga ned: write off, dismantle; avskriva, avveckla
avveckla: dismantle; lägga ner
tillföra: add, bring, supply; förse med ngt
tillkortakommande: shortcoming, deficiency; misslyckande
utvisa: expel, deport, send off; förvisa
ådagalägga: show, display, exhibit
blid: gentle, mild, soft, placid; mild, mjuk, lätt, lugn
svårmod: melancholy; tungsinthet
vidrig: obnoxious, vile, fowl
undsätta: rescue, relieve; rädda, lindra
underlag: basis, foundation
befälhavare: commander
ärelystnad: ambition
urtyp: archetype
framhärda: persevere, persist; envisas, vara ihärdig, hålla ut
avspänd: relaxed: avslappnad
hätsk: spiteful
försäga sig: say too much
på måfå: at random, haphazardly
bedåra: fascinate, infatuate; hänföra, förtjusa
olycksbådande: sinister, ominous
påbrå: stock, strain, descent, ancestry; arvsanslag, ursprung
mullvad: mole
anskaffa: procure, obtain
befordra: promote/convey/transport, ship
röja: reveal, betray/clean out, clear a path; förråda, avslöja/städa, hugga, gallra
fira sig ned: abseil
idel: sheer, mere, pure; uteslutande, enbart
vanföreställning: delusion, wrong idea
instämma i: agree with, second, declare agreement
allra helst: most preferably
angreppssätt: approach, angle
farled: fairway, waterway, sea-lane
skymma: obscure, obstruct, dim, conceal
det lär dröja: it will take a while
ta sig uttryck: express, manifest oneself
på eget bevåg: at one's own initiative
vederbörande: the person concerned
komma av sig: lose the thread, lose one's train of thought
rederi: shipping company
redovisning: accounting
nämnd: board, committee, jury
stävja: curb, stop, hold back; hejda
hejda: stop, hold back; hindra, stoppa
förebygga: prevent
sammanfalla: coincide
främja: promote, encourage
underskatta: underestimate; undervärdera
minnesvärd: memorable
inställning: attitude/adjustment
ta itu med: start doing, deal with
avisering: notification
trångsynt: narrow-minded
genomdriva: enforce
finslipa: hone
vördnadsfull: respectful, reverent
nederlag: defeat; förlust
gnaga: fret; oroa
uppochnervänd: upside-down
förstummad: dumbfounded, dumbstruck
generad: troubled/embarrassed; besvärad/förlägen
avleda: divert, distract
hojta: holler, shout
villrådig: irresolute, indecisive
utsökt: exquisite, fine; läcker
(en) ådra: vein
förleda: entice, mislead, entrap, delude
ryktbar: famous, renowned
näsvis: impertinent, cheeky; fräck, uppnosig
fräck: cheeky, brazen, insolent, impudent
vidta: implement, realise: genomföra
omhölja: envelop
belägga: prove/occupy/impose upon/cover,coat; bevisa/ta upp plats i/belasta/täcka
i sin linda: in the bud, in its tracks
linda: wind, wrap, twine; vira
vira: wind, twine, twist; linda, veckla
veckla: unfold, wind, wrap; vira, linda
brännmärka: brand, burn
tiga ihjäl ngt: silence sth
återge: reproduce, render, give back
tillbörlig: proper, decent
splittring: fragmentation, disruption
inbegripa: include, comprise; innefatta
medge: permit, concede, admit
häva: heave, expand; utvidga
upphäva: revoke, rescind, cancel; annullera
avskild: secluded, isolated
ogillande: disapproval, dismissal
(en) käke: jaw
sippra: trickle
dregla: drool
(ett) åtlöje: laughing stock
försiggå: be going on, take place
förbrylla: puzzle, perplex, baffle
domna: get numb, pass out
skutta: jump, scamper
huka: crouch
förlamad: paralysed
sia om: predict; förutsäga, spå
åtstramning: austerity
surra sig vid masten: getting ready for hard times and planning to stick around
utradera: wipe out; förinta
till syvende och sist: at the end of the day
halvledare: semiconductor
framgent: henceforth, in or for the future, forward
överskådlig: comprehensible, clear; överblickbar
överskådlig framtid: foreseeable future
fjärd: bay; vik
remsa: strip, tape, ribbon
utstående: protruding; utskjutande
utskjutande: protruding, sticking out
oändlighet: infinity
förmodan: presumption
upptuktelse: chastisement, severe punishment; tillrättavisning
ådra sig: catch, contract, incur
sidledes: sideways
(en) handled: wrist
(ett) spjut: spear
bedöva: stun
påträngande: intrusive; tränga sig på
ompröva: reconsider, reexamine
djärv: bold, daring, audacious
tapper: brave, valiant, courageous; modig
måhända: perhaps
slug: shrewd, cunning; klipsk, finurlig, listig, klok
frossa: overindulge, gorge/fever
begära: ask, demand
(en) balk: beam, girder
finkänslig: delicate
otäck: nasty; obehaglig, motbjudande
(ett) obehag: discomfort
överrumpla: catch off guard, catch in the act; o­väntat över­falla, över­raska, ertappa
studsa: bounce
rustning: armour
uthärdlig: bearable, tolerable
öm: sore, tender, affectionate
utsvulten: starving
anse: consider, regard
(en) seger: victory
överlista: outsmart, outwit, circumvent
angenäm: pleasant, enjoyable
vårdslös: careless, inattentive, non-chalant
slumpmässig: random
hånle: sneer
morsk: fearless, brave
överflödig: redundant
frånvaro: absence
belöning: reward, prize
undergång: downfall, doom
parktfull: marvellous; förunderlig
fördärva: corrupt, ruin, pervert; förstöra
odling: culture, cultivation
bly: lead
yrka: demand, plead; begära, kräva
avdrag: deduction, discount, rebate
spärra: lock
avspärra: block off
inspärra: confine, imprison
ombesörja: arrange for, take care of; ordna, åstadkomma
återvändsgräns: dead end
villebråd: prey, game
tillställning: event; bjudning, fest
vid sidan av: alongside, beside
kungöra: make known, announce; tillkännage, meddela
vinna laga kraft: gain legal force
skärskåda: review carefully, examine; noga betrakta, granska
(en) hop: crown, heap, pile: grupp, samling
upptänklig: imaginable, possible, conceivable
(ett) sorl: murmur
utryckning: emergency callout/discharge from active service
trassla: make a fuss; krångla
krångla: bitch, argue, give trouble; vålla besvär, trassla
erinra: remind; påminna
girighet: greed; snikenhet
oemotståndlig: irresistible, overpowering
skymning: dusk
gryning: dawn
tillvaro: existence, being; liv, existens
bredgrad: latitude
jävig: conflicting
köpslå: haggle, bargain; pruta
förtäta: condense
bejaka: affirm, assent to; acceptera
anhängare: supporter, follower
struntprat: nonsense
dvala: dormancy, hibernation
besegra: defeat, beat
bedröva: grieve, sadden: göra ledsen, förtvivla
förtvivlad: desperate; desperat, hopplös
(en) häpnad: amazement
(en) örfil: cheek slap
vädja: appeal, beg
göda: fatten
kätteri: heresy
vidskeplig: superstitious
lynnig: moody; nyck­full, o­beräknelig
underlätta: facilitate, ease
klentrogen: sceptical
snor: snot
oklanderlig: impeccable, immaculate, faultless; felfri
stökig: messy, untidy/troublesome, loud; o­städad; besvärlig, bråkig
hasa: slither, shuffle; glida, släpa
släpa: drag, tow
fästa: attach, fasten; sätta fast
hackig: choppy, jagged, stuttering; ojämn
sammanställning: compilation
besatt av: obsessed with
motig: difficult, that goes against
raljera: banter
avverka: cut down, fell; fälla
sammankomst: gathering; mote
moddig: slushy
avtrubba: numb, blunt
späd: tender, delicate
berbeta: process
(ett) ark: sheet of paper
underskön: gorgeous
i förhållande till: relative to, vis-a-vis
vig: agile, nimble
jag nänns inte: I don't have the heart to
(en) insyn: transparency, insight
buga för: bow
knyta: tie, fasten, knot, establish
petig: fussy, pedantic
dumdristig: foolhardy
klyftig: smart; klipsk
uppstötning: regurgitation
elände: misery, misfortune, wretchedness
skyldighet: obligation; plikt
försörja: support (a family)
(ett) klot: globe, ball, orb
inbilla: imagine (wrongly), make oneself believe
gäspa: yawn
stadig: steady, firm
darra: tremble, quiver
gripbar: tangible, comprehensible; begriplig
beröva: deprive
vedervärdig: disgusting, repulsive; avskyvärd, otäck
sval: cool
kräla: crawl; krypa
såvitt: as far as
häromdagen: the other day
ryta: roar
(ett) ärr: scar
överstökad: done, finished, complete
lurvig: shaggy
väsa: hiss
ömtålig: fragile, delicate
utstråla: radiate, emit, beam
omfamna: embrace, hug
iaktta: observe, watch; se på
baklänges: backwards
hårdhänt: harsh, rough; o­känslig, hänsyns­lös
förlag: publisher
outsinlig: endless, unfailing
umbäranden: hardship
umbära: do without; undvara, försaka
försaka: forego, deprive
ragla: stagger, lurch; vackla, vingla
verkställa: execute; utföra
verkställande utskott: executive committee
utskott: committee/outgrowth; underkommitté
duglig: competent, able
rysa: shudder, shiver
utgöra: constitude, compose of; bestå av
ytterligare: further, additional
(ett) skäl: reason: anledning, orsak
varsam: gentle, cautious; försiktig
kväva: choke, stifle, smother
prydlig: neat, tidy
såvida: unless
omfång: range, scope, extent; vidd/storlek, om­fattning
framstå: appear; te sig, visa sig
motsägande: contradictory, conflicting; motstridig
motstridig: conflicting
närgången: close, intrusive; på­trängande, på­flugen
elakartad: malignant; farlig
svulst: tumour; tumör
(en) åsyn: sight, view
skrocka: chuckle
tjuta: howl, wail
uppfart: driveway
(ett) spratt: prank, trick, hoax; streck, upp­tåg
ruska: shake; skaka
fördriva: dispel, drive away; driva bort
fördriva tiden: pass the time
genomtränga: penetrate, pierce
flämta: gasp, pant
häpnadsväkande: astonishing
förvrida: distort, warp
lättnad: relief
utstyrsel: outfit; dräkt
(en) ratt: steering wheel
(en) skock: flock, herd, crowd
rentav: even; till och med
uppväga: offset, compensate for; kompensera
förknippa: associate; associera, förbinda
uppenbarelse: revelation
faslig: dreadful, terrible; förskräcklig
förstulen: furtive
förnuftig: sensible, reasonable
storsint: magnanimous; generös, ädel­modig
ädelmod: magnanimity
angenäm: pleasant; behaglig
dallra: tremble; darra, vibrera, bäva, skälva
fillflykt: refuge, shelter
varav: of which
genväg: shortcut
(ett) staket: fence, railing
bemöta: meet, receive, treat; ta emot, svara på
gedigen: genuine, solid, pure
pladdra: prattle, babble
sålla: sift, screen, sieve
översålla: cover, saturate
(ett) häftstift: pin, thumbtack
medgörlig: tractable, compliant, accommodating, docile; tillmötes­gående, foglig
tillmötesgående: accommodating
oförskämd: rude, insolent; fräck, o­försynt
uppställning: line-up, formation
omvänd: inverse, reverse
framhäva: highlight, feature; understryka, betona
ypperlig: excellent, outstanding, extraordinary; utomordentlig
avsöka: scan
(en) manet: jellyfish
för övrigt: by the way, otherwise; i övrigt, förresten
däremot: however, on the contrary
därefter: then, thereafter, afterwards; sedan, där­på
därpå: thereon, then; sedan, där­efter
dessutom: moreover, furthermore; därutöver
därutöver: moreover, beyond; utöver detta
utröna: find out; ta reda på
äska: demand; begära, anhålla om
grannlaga: considerate, delicate; takt­full, fin­känslig
än mindre: let alone
detta till trots: despite this
gemen: common/mean, petty; vanlig, allmän/småsint
genomslag: impact
därtill: in addition
därav: hence
förpliktiga: oblige, obligate, bind; tvinga
stöta sig med: clash with, become enemies with
stöpa om: reshape, transform; omskapa
på sikt: in the long run
med tanke på: given that, considering
handlingskraft: power of action, energy, drive
(ett) dråp: manslaughter
förnödenheter: necessities; nödvändighetsvara
förtur: priority
förflyta: elapse, pass
samvaro: togetherness
(en) flit: diligence
övervinna: overcome, conquer, surmount; besegra
förkastlig: objectionable, to be condemned, unjustifiable; klander­värd
förkasta: reject, refuse; avslå, avvisa
avslå: reject, refuse; avvisa
anbud: tender, offer, bid
sunt förnuft: common sense
utrangera: discard, scrap; gallra ut, kassera
gallra: thin out, cull; avlägsna
avlägsna: remove, put away; skaffa bort
befogenhet: authority, capacity, competence; rättighet, behörighet
(en) tillit: trust
samstämmighet: consensus, unanimity; enighet
samråd: consultation
förankra: anchor, establish firmly
ömsesidig: mutual
på dekis: dilapidated; förfallen
rycka bort: snatch away, carry off
rycka in: step in/join up
rycka fram: advance, push forward
avmatta: tire, weaken
uppfostringsanstalt: reformatory, institution for juveniles
uppdämd: pent-up; länge tillbaka­hållen
utse: appoint, choose; tillsätta, besätta
nödga: need, force; halvt tvinga
begivenhet: big and rare event/addiction
görlig: feasible, practicable
blidka: appease, placate
avhängig: dependent; beroende
eftergift: remission, concession, compromise
sluta upp: gather/give support; samlas/ge sitt stöd
brokig: motley
greppa: grab, handle/get, understand; ta tag i, hantera/fatta, förstå
hävstång: lever
vådabekämpning: friendly fire
utropa: proclaim, call out
fjärma: alienate, remove, estrange; föra bort, skilja, av­lägsna
fnittra: giggle; fnissa
anamma: embrace, accept
hyfsad: decent
bullrig: noisy
föregå av: precede by
stel: stiff, rigid
tafatt: awkward, clumsy; fumlig, klumpig
motvikt: counterbalance, counterweight
anförtro: confide
förtrolig: confidential, intimate, close
glo: stare
sno: twist, twirl/steal; snurra, vrida/stjäla
snurra: spin, twirl
utantill: by heart
påfågel: peacock
förtal: slander
vettig: sensible
skylla på: blame for
anklaga för: accuse of
åtala för: charge with
åtala: prosecute
omintetgöra: thwart
uppbringa: produce/hijack, capture; skaffa fram/kapa
kapa: hijack, capture
näppeligen: hardly; knappast
påfresta: strain; anstränga
hänga ihop: hang together, connect, interlink; hänga samman
störa ut: jam
graverande: troublesome, aggravating; besvärande, försvårande
vidkommande: concerned, relevant
för mitt vidkommande: as far as I'm concerned; för min del, vad mig beträffar
svältkur: starvation diet
utflykt: outing, excutsion
krånglig: complicated, awkward
hämnas på: avenge
enslig: desolate, remote; ödslig
hednisk: pagan
förvalta: administer, manage
svetsa: weld
skänka: give, donate
tilltänkt: intended; planerad
rasande: furious; ursinnig
ursinnig: furious, enraged
(en) bordell: brothel
kärra: cart
(ett) svärd: sword
(en) skorsten: chimney
(en) bål: torso
(ett) bål: bonfire
välgörenhet: charity
trakassera: harass
mobba: bully
(en) säl: seal
roa: entertain, amuse; under­hålla, förströ
ligga till: have a certain position, be placed
bemyndigande: authorisation, authority; tillstånd
knapphänding: scant; kortfattad, fåordig
skalbar: scalable
luffare: bum, tramp
koka soppa på en spik: make bricks without straw, accomplish something out of nothing
huruvida: whether; om
ligga ute med pengar: be out of pocket
tongång: tone
på/å någons vägnar: on behalf of; för någons räkning
mordbrand: arson
i samma vända: at the same time
ombud: agent, proxy
förehavanden: undertakings, actions; görande, agerande
oundgänglig: indispensable, essential; oumbärlig, o­frånkomlig
eftertrakta: covet; längta efter
rättmätig: legitimate
få sin beskärda del: get one's fair share
motstycke: counterpart; motsvarighet
skona från: spare from; ge nåd
bristfällig: inadequate, insufficient; otillräcklig
illasinnad: ill-tempered, ill-disposed; elak
för all del: by all means
utfästelse: pledge, commitment
sund: sound, healthy, sane; frisk, hälsosam, klok
förekomst: presence, existence
lyda: obey
feg: coward
gnälla: whine, moan, complain; jämra sig, klaga
jämra sig: moan; klaga, gny
slösaktig: wasteful, lavish
rattfylleri: drunk driving
slå vad: bet, wager
än en gång: once again
rastlös: restless
busig: mischievous
benåda: pardon
uppsluka: engulf, absorb
fastna för: get hooked on
fastna: get caught in, stick
ordagrann: verbatim, word for word
enkom: solely; enbart
sammvetgrann: conscientious; nog­grann, ansvars­full
knackig: bad, poor; dålig, ekonomiskt besvärlig
döpa till: name, baptise
utsmyckning: ornamentation, decoration
(en) smet: batter
dela ut: distribute
inuti: inside, within
oförrätt: injustice; orättvisa
upphandling: procurement, purchase
syfte: purpose, aim, idea, intention; av­sikt, ända­mål
allt som oftast: most of the time, almost always
stick i stäv: opposite, contrary; tvärtemot
bemärkelse: sense; betylse
i någon bemärkelse: in some sense
bevandrad: versed; insatt, beläst
ringa: small, little, simple; liten, enkel
förgänglig: perishable, transient
inslag: element
gröpa ur: dig out, hollow out
komma i mål: reach a goal
omkomma: perish, die; avlida, dö
fullborda: complete, finalise
omgående: immediately; omedelbart, genast
inteckna: mortgage
niga: curtsey
underkänna: fail, flunk
skala: peel
på länge: in a long time
gå vilse: get lost
enformig: drab, monotonous
omväxlande: varied, diversified
överilad: hasty, rash, impulsive; ogenomtänkt
tärna: bridesmaid, court lady
tigga: beg
ljuvlig: lovely, delightful; härlig, förtjusande
ljuv: sweet, delightful; härlig
kvittra: tweet, chirp
(ett) bur: cage
vistelse: stay, visit
utsläpp: emission
flotte: raft
reta: tease, irritate
begagnad: used, second-hand
knep: trick, trickery
hal: slippery
begå: commit
beundra: admire
fräsig: crisp
ta till: resort
hålla reda på: keep track of
smyga: sneak
avrätta: execute
avskeda: fire, dismiss
myndig: adult, of age
äga rum: take place
genomföra: carry on
rista: carve
slå igenom stort: to hit it big
folkomröstning: referendum
gå på högvarv: go on overdrive
högkonjunktur: boom
värdering: evaluation, assessment
förvandla: turn, transform
prakt: splendour
klia: scratch
fuska: cheat
förekomma: occur, anticipate, forestall, prevent
uppfinna: invent
invadera: invade
erövra: conquer
landsbyggden: countryside
viska: whisper
råka: happen to
snatta: pilfer
(en) kulle: hill
vishet: wisdom
valspråk: motto
älta: dwell on, brood
budskap: message; meddelande
påpeka: point out
foglossning: joint dislocation
skända: defile, violate/rape; vanära, kränka/våldta
luckra: loosen
belägen: located, situated
hets: incitement
saklig: objective, factual
jämställdhet: equality
snöra av: untie
skylla ifrån sig: put the blame on someone else
upprop: attendance control/rollcall/appeal; närvarokontroll
(en) ränsel: knapsack; ryggsäck
reda ut: sort out/unravel, disentangle; ordna/undersöka
ligga efter: lag behind, fall behind
tvinna: twist, tangle, twine
uppteckna: record
underdånig: subservient, submissive; undegiven, hörsam
hörsam: obedient; lydig
sladd: cord, cable/skid
omlopp: circulation, circuit; kretslopp, circulation
omloppsbana: orbit
stöta ut: eject
eftertänksam: prudent
utreda: investigate; undersöka
häkta: detain
förhöra: interrogate
hederlig: honest, decent
taskig: shitty, mean; elak, dålig
samvete: conscience
samvetsgrann: conscientious; nog­grann, ansvars­full
däst: saturated, full; övermätt, stinn
stinn: full, replete, satiated
(ett) hull: flesh
sedlig: sexually moral
försluta: close, seal, lock; tillsluta
skottkärra: wheelbarrow
tilltala: appeal to/address, speak to/accuse; behaga/tala till/åtala
häftig: intense/cool
fjädring: suspension
spänst: elasticity; elasticitet
stämning: mood, atmosphere
(en) synd: sin
grym: cruel
folklig: popular; populär
krympa: shrink
ge sig iväg: set off, get going
ringla: curl, wreathe
tjata: nag
skumpa: jolt
anläggning: facility
rätt åt ngn: deservedly; välförtjänt
åtskillnad: distinction
försjunkenhet: absorption, immersion; nedsänkning
bröla: animal roar
skrovlig: rough, rugged; grov, oslipad
slipa: polish, grind
smicker: flattery
(ett) ide: hibernation den
stamfader: progenitor, ancestor
vifta: wave, whisk
spola: flush, rinse; skölja
vissla: whistle
päls: fur
(en) örn: eagle
lufsa: shamble
avskaffa: abolish; göra slut på, upphäva
förorening: pollution
pank: broke, skint
fästing: tick
geting: wasp
stöta på: bump into, encounter
snuvig: to have a runny nose
lunka: trot, jog, plod; trava
trava: trot
genombrott: breakthrough
flintskallig: bald
kåda: resin
smaska: chew
uppsikt: supervision, control; tillsyn
tillsyn: supervision, oversight; uppsikt, övervakning
flitig: diligent; arbetsam, ihärdig
tät: close, thick
brant: steep
stig: path
gå vilse: get lost
klippa: cliff
ta en dopp: take a dip
göra upp: think of, come up with, create/agree; tänka ut, skapa
uppgörelse: argument, fight/arrangement, agreement
spillning: droppings
byig: gusty
(en) ål: ell
trofast: faithful, loyal; trogen, lojal
dräktig: pregnant with calf
(en) jäst: yeast, ferment
överdriva: exaggerate
spela in: record
korkad: stupid, brainless
emellertid: however; dock, ändå
till en början: initially, to begin with
snopen: baffled, surprised
emellanåt: occasionally; vid somliga till­fällen, i­bland
minsann: surely, indeed; sannerligen, förvisso
kors och tvärs: left and right, in all directions
(en) näbb: beak
utforska: explore
(ett) intryck: impression
(en) skörd: harvest
(en) korp: raven
fruktsamhet: fertility
fruktbarhet: fruitfulness
(en) vidskepelse: superstition; skrock, vantro
förhållandevis: relatively; jämförelsevis, tämligen
inneha: own, possess; äga, besitta
avläggare: offshoot
fullgöra: fulfill, carry out, execute; utföra, uppfylla
avge: give, give out, give off, emit
avlägga examen: obtain a degree
avlägga ed: take an oath
avlägga ett besök: make an official visit
avlägga rapport: give a report
slamra: rattle, bang; skramla, dunka
skramla: rattle, clatter, clank
dunka: pound, thump; banka
frälst: convert, believer; om­vänd, troende
väja för: turn away from, make way for; vika undan
arta sig: take shape, fall into place
målbrott: voice break
förhänge: curtain, drapery
tyna: fade, languish; försvagas, bli kraftlös
slita upp: rip open, tear up
sövning: anesthesia
anvisning: instruction, direction; instruktion
härbärge: hostel
ovidkommande: irrelevant
ålderdom: old age, declining years
versal: capital letter
basunera ut: announce loudly, publicly, broadcast
överklaga: appeal
angå: concern, pertain; beröra
beröra: touch/deal with, comment on/affect; vidröra/behandla, kommentera/påverka
vidröra: touch; ta på
ta på: touch; röra
blända: dazzle, blind
haka upp sig: get stuck, get caught
se sig för: look out, be careful; vara upp­märksam och försiktig
upptrappa: escalate
utåt: outwards, outwardly
långsint: resentful, holding on to grudge
nässla: nettle
korsrygg: lower back
kråka: crow
genomborra: pierce through; tränga igenom
tränga: crowd, push
dy: sludge, slime, mud, ooze; gyttja
gyttja: mud, ooze, slime
trollslända: dragonfly
murken: rotten
stock: log
lägga ngn till last: blame someone for something; klandra, an­klaga ngn för ngt
ligga ngn till last: burden; börda, vara ett problem för ngn
avfälling: apostate
förirra sig: get lost; gå vilse, tappa orienteringen
bortstött: rejected
stött: offended, hurt; förnärmad, sårad
domkraft: jack
slita i: tug
rubba: budge, dislodge
(ett) tegel: brick, tile
intrasslad: entangled; tilltrasslad
skärva: fragment, shard, sliver
förvissning: assurance, conviction
navelsträng: umbilical cord
utpräglad: pronounced, distinctive; tydlig, påtaglig
understå sig: presume, dare; våga, vara fräck nog
iögonfallande: conspicuous; påfallande
påfallande: striking; slående
slående: striking, eye-catching; påfallande
dräpa: slay, kill; döda
rena rama: pure and simple, downright, sheer
ämna: intend to
komma åt: access; få tillgång till
avstå: refrain, abstain; låta bli
bli av med: lose; mista, förlora
gänglig: lanky, slender, slim; lång och smal
(ett) etui: case: fodral, ask
åthuta: admonish, strongly reprimand
tillgjord: artificial, contrived; förkonstlad
förkonstlad: contrived; tillgjord, onaturlig
(sent) omsider: finally, at last; slutligen, äntligen
odåga: deadbeat; odugling
utstött: outcast
gäcka: thwart, impede, obstruct
ärevördig: venerable, awe-inspiring; respekt­ingivande
anbelanga: concern; beträffa, angå
ställa till: arrange, accomplish; ordna, åstadkomma
knipslug: sly; listig, knepig
fjäll: mountain/scale, flake
åta sig: take on
rovfågel: bird of prey
inte mödan värt: not worth the effort; lönlösт
niding: cheat, crook, rogue
sätta näsan i vädret: act superior
inhägna: enclose, fence off
framställa: produce, make; tillverka
vanvett: mania, frenzy; vansinne
vansinne: madness, insanity, lunacy; galenskap
upptåg: prank
förelägga: command, order, impose; ålägga
ålägga: impose, order; förelägga, avkräva
tjudra: tether
överdåd: extravagance; överflöd, lyx
överflöd: abundance, opulence
vidhålla: maintain, insist on; stå fast vid
(en) tygel: bridle, rein
tarvlig: cheap, shabby, common, paltry; lumpen
lumpen: shabby, paltry; tarvlig
(ett) agg: grudge, resentment; avoghet, hätskhet, avsky
avoghet: aversion
i färd: in progress
less: tired; trött
fnissa: giggle; fnittra
avstamp: kickoff, takeoff
tillgripa: resort to/steal, take unlawfully; ta till/stjäla, olovligt ta
drämma: smash, wham; slå, smälla
bödel: executioner, hangsman
lägga band på: restrain, curb
oskadliggöra: neutralise, render harmless
fjättra: shackle
vricka: sprain, twist
dumbom: fool
långsökt: far-fetched
övertånden: done, over
ostyrig: frisky, lively/unruly, rowdy; yster/bråkig
yster: lively, frisky
ta tillfället i akt: seize the opportunity; passa på, utnyttja situationen
ingripa: intervene, interfere
kugga: fail an exam; underkänna
avyttra: sell, dispose of; sälja, avhända sig
uppkomma: arise, come into being; komma till stånd, uppstå
komma till stånd: come into being
rätt och slätt: quite simply, plain and simple
proviant: provisions
(en) åtbörd: gesture; gest
förskjuta: displace, shift/reject, repudiate
särling: oddball
ingivelse: impulse
se tiden an: wait and see; avvakta
avvakta: wait, await, wait and see, sit tight; vänta
viljeakt: volition
mala: grind, mill/harp on
utdragen: prolonged, protracted; långvarig
rabbla: rattle, jabber
irra: wander
tilldragelse: event, occurrence; händelse
dårskap: folly, madness
(ett) gemak: grand hall; praktrum
förbruka: consume, expend, use up, exhaust
(en) rand: stripe/edge, verge, brink; streck/kant
oförrättat ärende: unfinished business
leda: disgust, displeasure; avsky, olust
rumstera: rummage about; stöka
stå pall: cope; härda ut
förtära: consume, ear or drink
hämma: impede, obstruct, inhibit; hindra, hejda, dämpa
mögla: become moldy
tillräknelig: accountable, responsible
orsak och verkan: cause and effect
en dag i sänder: one day at a time
komprimera: compress; pressa ihop, trycka ihop
förspilla: waste, lose, forfeit
torka: drought
ödla: lizard
skräcködla: dinosaur
välde: empire, reign
frodas: thrive, flourish; blomstra
undestundom: sometimes, at times; ibland
förmäten: presumptuous, audacious; anspråksfull, övermodig
dia: suckle/nurse
skriande: flagrant, glaring, gross; uppenbar, upprörande
vedermöda: tribulation, hardship; besvär
besätta: occupy/fill a role
(en) dolk: dagger, dirk
(en) syl: awl
intyga: certify, attest, testify; vittna om
ge vid handen: prove, show, indicate
ingalunda: by no means, no way; absolut inte
på tok: awry, amiss; fel, åt skogen
gripa sig an: go about, proceed, tackle
inmatning: input, feed
bråkdel: fraction
visa upp: show, display, exhibit, demonstrate
så när: nearly, almost; nästan
ransonera: ration
alstra: generate, produce; frambringa, skapa
frambringa: produce, bring forth, create, generate
lämpligen: appropriately, suitably, conveniently; gärna
förfäkta: advocate, defend; förespråka
turning: dice
utsira: decorate with ornaments; pryda, smycka
föreviga: immortalise
avbilda: paint, reproduce, depict
evärdlig: eternal; evig
påfrestande: stressful, trying; tröttsam, irriterande
förborga: hide, conceal, keep secret; dölja, hemlighålla
beskedlig: modest, good-natured/shy; försynt, snäll/blygsam
laka ur: leach out; dra ut ur
gobeläng: tapestry
varsebli: perceive; uppfatta, förnimma
tillförsikt: confidence; tillit, förtröstan
stoft: dust, ask
futtig: paltry, measly; obetydlig
fridlysa: protect, place under protection
flå: skin, flay
nysta: wind, unravel; linda, vira
anrik: historic, traditional
föröda: devastate; förstöra, ödelägga
ryka: smoke/die, perish; röka/gå åt, stryka med
erfordra: require, demand; fordra, kräva
gå åt: require, consume/die, perish; förbrukas, erfordras/omkomma, stryka med, ryka
stryka med: die, bite the dust, perish; gå under, omkomma
självsvåld: arrogance, haughtiness
okynne: mischief
skära sig: fall out, clash
sätta sin sista potatis: be done for